Level 2: String board = "PA PA PA PA PA PA PA PA PA PA PA PA PA PA PA PA PA PA PA PA PA PA\n"+
"PA PA PA PA PA PA PA PA PA PA PA PA PA PA PA PA PA PA PA PA PA PA\n"+
"PA PA PA PA WA WA WA WA WA WA WA PA PA PA PA PA PA PA PA PA PA PA\n"+
"PA PA PA PA WA PA PA TR PA PA WA PA PA PA PA PA PA PA PA PA PA PA\n"+
"PA PA PA PA WA PA PA PA PA PA WA PA PA PA PA PA PA PA PA PA PA PA\n"+
"PA PA PA PA WA PA PA WA PA PA WA WA WA WA WA WA WA WA WA WA PA PA\n"+
"PA PA WA WA WA PA PA WA EN PA PA WT WT PA PA PA PA PA TR WA PA PA\n"+
"PA PA WA EX EL PA PA WA WA EN PA WT WT PA XX XX CH IN PA WA PA PA\n"+
"PA PA WA WA WA PA PA WA EN PA PA WT WT PA PA PA PA PA TR WA PA PA\n"+
"PA PA PA PA WA PA PA WA PA PA WA WA WA WA WA WA WA WA WA WA PA PA\n"+
"PA PA PA PA WA PA PA PA PA PA WA PA PA PA PA PA PA PA PA PA PA PA\n"+
"PA PA PA PA WA PA PA TR PA PA WA PA PA PA PA PA PA PA PA PA PA PA\n"+
"PA PA PA PA WA WA WA WA WA WA WA PA PA PA PA PA PA PA PA PA PA PA\n"+
"PA PA PA PA PA PA PA PA PA PA PA PA PA PA PA PA PA PA PA PA PA PA\n"+
"PA PA PA PA PA PA PA PA PA PA PA PA PA PA PA PA PA PA PA PA PA PA";